id	int	NO	PRI		auto_increment
tecnico	varchar(255)	YES			
razaoSocial	varchar(255)	YES			
cnpj	varchar(255)	YES			
endereco	varchar(255)	YES			
numero	varchar(50)	YES			
responsavel	varchar(255)	YES			
setor	varchar(255)	YES			
cidade	varchar(255)	YES			
dataInicio	date	YES			
horaInicio	time	YES			
dataTermino	date	YES			
horaTermino	time	YES			
horaIntervaloInicio	time	YES			
horaIntervaloTermino	time	YES			
horaIntervaloInicio2	time	YES			
horaIntervaloTermino2	time	YES			
instalacaoDeEquipamentos	tinyint(1)	YES			
manutencaoDeEquipamentos	tinyint(1)	YES			
homologacaoDeInfra	tinyint(1)	YES			
treinamentoOperacional	tinyint(1)	YES			
implantacaoDeSistemas	tinyint(1)	YES			
manutencaoPreventivaContratual	tinyint(1)	YES			
repprintpoint2	tinyint(1)	YES			
repprintpoint3	tinyint(1)	YES			
repminiprint	tinyint(1)	YES			
repsmart	tinyint(1)	YES			
relogiomicropoint	tinyint(1)	YES			
relogiobiopoint	tinyint(1)	YES			
catracamicropoint	tinyint(1)	YES			
catracabiopoint	tinyint(1)	YES			
catracaceros	tinyint(1)	YES			
catracaidblock	tinyint(1)	YES			
catracaidnext	tinyint(1)	YES			
idface	tinyint(1)	YES			
idflex	tinyint(1)	YES			
nSerie	varchar(255)	YES			
localinstalacao	varchar(255)	YES			
observacaoproblemas	text	YES			
impressora	tinyint(1)	YES			
fonte	tinyint(1)	YES			
cabecote	tinyint(1)	YES			
leitor	tinyint(1)	YES			
codigoImpressora	varchar(255)	YES			
codigoFonte	varchar(255)	YES			
codigoCabecote	varchar(255)	YES			
codigoLeitor	varchar(255)	YES			
assinatura	text	YES			
observacoes	text	YES			
prestadoraDoServico	varchar(255)	YES			
date	datetime	YES		CURRENT_TIMESTAMP	DEFAULT_GENERATED
file	varchar(255)	YES			